2,14,12,6,12,6,10,10,10,12
6,9,3,9,7,15,14,14,10,13
7,14,10,12,7,9,5,7,14,13
5,7,14,15,11,10,13,7,9,5
5,7,11,11,12,6,15,13,6,9
5,5,2,14,13,7,13,7,13,4
7,15,14,15,15,15,11,13,7,13
5,5,7,11,9,7,10,15,13,5
7,13,7,10,12,3,12,7,11,13
3,11,11,8,3,10,11,11,10,9
